10 10
1 1 1 1 1 1 1 1 1 1
1 0 0 0 0 0 0 0 0 1
1 0 1 1 1 1 1 1 0 1
1 0 1 0 0 0 0 1 0 1
1 0 1 0 0 0 0 0 0 1
1 0 1 1 1 1 1 1 0 1
1 0 0 0 0 0 0 0 0 1
1 0 0 0 0 0 0 0 0 1
1 0 0 0 0 0 0 0 0 1
1 1 1 1 1 1 1 1 1 1
1
8 3
1
4 7