12 13
1 1 1 1 1 1 1 1 1 1 1 1 1
1 0 1 0 0 0 0 0 0 0 0 0 1
1 0 0 0 0 1 1 1 1 1 1 1 1
1 0 1 1 0 1 0 0 0 0 0 0 1
1 0 1 0 0 1 1 1 1 1 1 0 1
1 0 1 1 0 0 0 0 0 0 1 0 1
1 0 1 0 0 1 0 0 0 0 1 0 1
1 0 1 1 0 1 0 0 0 0 1 0 1
1 0 1 0 0 1 0 0 0 0 1 0 1
1 0 1 1 1 1 1 1 1 1 1 0 1
1 0 0 0 0 0 0 0 0 0 0 0 1
1 1 1 1 1 1 1 1 1 1 1 1 1
1
6 6
4
4 7
11 2
11 7
9 12