24 9
1 1 1 1 1 1 1 1 1
1 1 0 0 0 0 0 0 1
1 0 1 0 0 0 0 0 1
1 0 0 1 0 0 0 0 1
1 0 0 0 1 0 0 1 1
1 0 0 0 0 0 1 0 1        
1 0 0 0 0 1 0 0 1
1 1 0 0 1 0 0 0 1
1 0 1 0 0 0 0 0 1
1 0 0 1 0 0 0 0 1
1 0 0 0 1 0 0 1 1 
1 0 0 0 0 0 1 0 1
1 0 0 0 0 1 0 0 1         
1 1 0 0 1 0 0 0 1
1 0 1 0 0 0 0 0 1
1 0 0 1 0 0 0 0 1
1 0 0 0 1 0 0 1 1 
1 0 0 0 0 0 1 0 1
1 0 0 0 0 1 0 0 1
1 1 0 0 1 0 0 0 1
1 0 1 0 0 0 0 0 1
1 0 0 1 0 0 0 0 1
1 0 0 0 0 0 0 0 1 
1 1 1 1 1 1 1 1 1
1
2 3
7
3 2
6 8
9 2
12 8
15 2
18 8
21 2
