10 10
1 1 1 1 1 1 1 1 1 1
1 0 0 0 0 0 0 0 0 1
1 0 1 1 1 0 1 1 1 1
1 0 0 0 1 0 1 0 1 1
1 1 0 1 1 0 0 0 0 1
1 0 0 0 0 0 0 1 1 1
1 1 1 1 0 1 1 1 0 1
1 0 0 0 0 0 0 0 0 1
1 0 1 0 1 0 1 0 1 1
1 1 1 1 1 1 1 1 1 1
4
2 2
2 9
8 9
9 2
1
9 8