10 10
1 1 1 1 1 1 1 1 1 1
1 0 0 0 0 0 0 0 0 1
1 0 1 1 1 0 1 1 1 1
1 0 0 0 1 0 1 0 1 1
1 1 0 1 1 0 0 0 0 1
1 0 0 0 0 0 0 1 1 1
1 1 1 1 0 1 1 1 0 1
1 0 0 0 0 0 0 0 0 1
1 0 1 0 1 0 1 0 1 1
1 1 1 1 1 1 1 1 1 1
1
2 2
8
4 4
4 8
5 9
6 2
6 7
9 4
9 6
9 8

2 9
8 9
9 2